{    
    "maps": [
        {
            "name": "Elder Growth",
            "portals": [
                [16, 8, "Plutus' Fields"]
            ],
            "spaces": [
                ["X", "X", "X", "X", "X", "X", "X", "X", "X", "X", "X", "X", "X", "X", "X", "X", "X"],
                ["X", "G", "G", "G", "G", "G", "G", "G", "G", "G", "G", "G", "G", "G", "G", "G", "X"],
                ["X", "G", "G", "G", "G", "G", "G", "G", "G", "G", "G", "G", "G", "G", "G", "G", "X"],
                ["X", "G", "G", "G", "G", "G", "G", "G", "G", "G", "G", "G", "G", "G", "G", "G", "X"],
                ["X", "G", "G", "G", "G", "G", "G", "G", "G", "G", "G", "G", "G", "G", "G", "G", "X"],
                ["X", "G", "G", "G", "G", "A", "A", "A", "A", "A", "A", "A", "G", "G", "G", "G", "X"],
                ["X", "G", "G", "G", "A", "A", "G", "G", "G", "G", "G", "A", "A", "G", "G", "G", "X"],
                ["X", "G", "G", "A", "A", "G", "G", "X", "X", "X", "G", "G", "A", "A", "G", "G", "X"],
                ["X", "G", "G", "A", "G", "G", "X", "X", "X", "X", "X", "G", "G", "A", "G", "G", "P"],
                ["X", "G", "G", "A", "G", "G", "X", "X", "X", "X", "X", "G", "G", "A", "G", "G", "X"],
                ["X", "G", "G", "A", "A", "G", "G", "X", "X", "X", "G", "G", "A", "A", "G", "G", "X"],
                ["X", "G", "G", "G", "A", "A", "G", "G", "G", "G", "G", "A", "A", "G", "G", "G", "X"],
                ["X", "G", "G", "G", "G", "A", "A", "A", "A", "A", "A", "A", "G", "G", "G", "G", "X"],
                ["X", "G", "G", "G", "G", "G", "G", "G", "G", "G", "G", "G", "G", "G", "G", "G", "X"],
                ["X", "G", "G", "G", "G", "G", "G", "G", "G", "G", "G", "G", "G", "G", "G", "G", "X"],
                ["X", "G", "G", "G", "G", "G", "G", "G", "G", "G", "G", "G", "G", "G", "G", "G", "X"],
                ["X", "G", "G", "G", "G", "G", "G", "G", "G", "G", "G", "G", "G", "G", "G", "G", "X"],
                ["X", "X", "X", "X", "X", "X", "X", "X", "X", "X", "X", "X", "X", "X", "X", "X", "X"]
            ],
            "entities": [
                [14, 14, "inanimate", "Pandora's Box"]
            ]
        },

        {
            "name": "Plutus' Fields",
            "portals": [
                [0, 4, "Elder Growth"],
                [16, 12, "Plutus' Shack"]
            ],
            "spaces": [
                ["X", "X", "X", "X", "X", "X", "X", "X", "X", "X", "X", "X", "X", "X", "X", "X", "X"],
                ["X", "G", "G", "G", "G", "G", "G", "G", "G", "G", "G", "G", "G", "G", "G", "G", "X"],
                ["X", "G", "G", "G", "G", "G", "G", "G", "G", "G", "G", "G", "G", "G", "G", "G", "X"],
                ["X", "G", "G", "G", "G", "G", "G", "G", "G", "G", "G", "G", "G", "G", "G", "G", "X"],
                ["P", "G", "G", "G", "G", "G", "G", "G", "G", "G", "G", "G", "G", "G", "G", "G", "X"],
                ["X", "G", "G", "G", "G", "G", "G", "G", "G", "G", "G", "G", "G", "G", "G", "G", "X"],
                ["X", "G", "G", "G", "G", "G", "G", "G", "G", "G", "G", "G", "G", "G", "G", "G", "X"],
                ["X", "G", "G", "G", "G", "G", "G", "G", "G", "G", "X", "X", "X", "X", "X", "X", "X"],
                ["X", "G", "G", "G", "G", "G", "G", "G", "G", "G", "X", "G", "G", "G", "X", "X", "X"],
                ["X", "G", "G", "G", "G", "G", "G", "G", "G", "G", "X", "G", "G", "G", "X", "X", "X"],
                ["X", "G", "G", "G", "G", "G", "G", "G", "G", "G", "X", "G", "G", "G", "X", "X", "X"],
                ["X", "G", "G", "G", "G", "G", "G", "G", "G", "G", "G", "G", "G", "G", "G", "G", "X"],
                ["X", "G", "G", "G", "G", "G", "G", "G", "G", "G", "G", "G", "G", "G", "G", "G", "P"],
                ["X", "G", "G", "G", "G", "G", "G", "G", "G", "G", "G", "G", "G", "G", "G", "G", "X"],
                ["X", "G", "G", "G", "G", "G", "G", "G", "G", "G", "X", "G", "G", "G", "G", "G", "X"],
                ["X", "G", "G", "G", "G", "G", "G", "G", "G", "G", "X", "G", "G", "G", "G", "G", "X"],
                ["X", "G", "G", "G", "G", "G", "G", "G", "G", "G", "X", "G", "G", "G", "G", "G", "X"],
                ["X", "X", "X", "X", "X", "X", "X", "X", "X", "X", "X", "X", "X", "X", "X", "X", "X"]
            ],
            "entities": [
                [11, 9, "inanimate", "Wheat"],
                [11, 10, "inanimate", "Wheat"],
                [11, 11, "inanimate", "Wheat"],
                [12, 9, "inanimate", "Wheat"],
                [12, 10, "inanimate", "Wheat"],
                [12, 11, "inanimate", "Wheat"],
                [13, 9, "inanimate", "Wheat"],
                [13, 10, "inanimate", "Wheat"],
                [13, 11, "inanimate", "Wheat"],
                [12, 14, "mob", "Sheep"],
                [14, 14, "mob", "Sheep"]
            ]
        }
    ]
}